Платформа	Процессор двухъядерный A8 800 МГц, операционная систем WindowsCE
Параметры дисплея	6,2" сенсорный TFT LCD, высокого разрешения 800х480 точек.
Поддержка интернет-доступа подключение Wi-Fi	нет
Встроенный GPS приемник, Навигационное ПО в комплекте на карте памяти	Навител Россия 
Возможность выхода в Интернет , отображение пробок на дороге	опционально (модем GPS 3G)
Встроенный FM/AM тюнер с функцией RDS	есть 12/18
Поддержка CD/DVD	CD, CD-R/RW, VCD, DVD, DVD-R, DVD+R, DVD-RW/+RW
Поддержка SD/MMC/USB	есть
Поддержка Bluetooth, записная книжка контактов	есть, микрофон встроенный
Поддержка форматов файлов фото	JPEG, GIF, PNG, BMP
Поддержка аудио форматы	MP3, MP2, ACC, OGG, RA, WAV, FLAC, APE
Поддержка форматов видео	H.264/MPEG-4, RMVB, AVI, WMV, 3GP, MP4, MOV, MPG, VOB
Русифицированное меню	есть
Поддержка кнопок руля	есть
Аналоговый ТВ-тюнер	внешний встроенный тюнер
Цифровой ТВ-тюнер	опционально (тюнер DTV-T2)
Подключение камеры заднего вида	возможное подключение штатной камеры и универсальной 
Аудио выходы на усилитель	есть
Отдельный выход на сабвуфер	есть 
Возможность подключения дополнительных мониторов, внешнего источника A/V сигнала	есть

Доставка, установка, гарантия 12 мес.