Стандартная комплектация:
-	стандартный барабан с зубьями для асфальта
-	независимая механическая лево- и правосторонняя регулировка глубины с помощью телескопических винтов
-	механическая плавающая система амортизации продольного наклона
-	механический боковой сдвиг с универсальными соединениями
-	шланги и брс для мини-погрузчиков с бортовым поворотом A+B (2 линий гидравлики)

Параметры	Exten Lambo 38.18
  Глубина фрезерования, мм	0-180
  Ширина фрезерования, мм	380
  Кол-во зубьев на цилиндре (асфальт / бетон)	48 / 64
  Кол-во зубьев на цилиндре (многозубцовый)	200
Средняя производительность (стандартный цилиндр, 50% глубины), см/мин.	120-600
Регулировка по глубине	независимая по двум сторонам, механическая / гидравлическая (по запросу)
  Боковой сдвиг	Механический / гидравлический (по запросу)
  Сдвиг (стандарт / по запросу), мм	800 / 650
  Минимальное расстояние от тротуара (стандарт   / по запросу), мм	50 / 30
Наклон	автоматический
  Управление	Гидравлический(по запросу)
  Угол наклона, градусы	16
Рабочий вес, кг	590(*)-850
Требования к носителю
  Необходимый поток масла, л/мин.	45-75
  Необходимое давление, бар	240-160
Контейнер для воды (по запросу)	Комплект с электронасосом для мини-погрузчика с бортовым поворотом или встроенный в систему бокового сдвига