Тип	планшетный ПК
Операционная система	Android 4.0
Процессор
Частота процессора	1 ГГц
Объём памяти
Тип оперативной памяти	DDR SDRAM
Объем оперативной памяти	1024 МБ
Объем накопителя	16 ГБ
Устройство чтения карт памяти	microSD
Изображение
Тип экрана	жидкокристаллический
Диагональ экрана	10.1 "
Разрешение и формат экрана	1280 x 800 WXGA 16:10
Особенности	емкостной
Камера	фото/видеокамера
Разрешение камеры	3 Мпикс.
Особенности	0.3 МПикс. фронтальная камера
Устройства ввода
Устройство ввода	сенсорный экран
Управление курсором	сенсорный экран ; 
Звук
Звуковые устройства	микрофон ; динамик
Способы подключения и соединения
Тип сети	беспроводной доступ к сетям HSUPA/WCDMA ; беспроводная связь Bluetooth V3.0 ; беспроводная связь Wi-Fi
Беспроводные стандарты	IEEE 802.11b ; IEEE 802.11g ; IEEE 802.11n
Система навигации	A-GPS ; ГЛОНАСС
Интерфейсы / Коннекторы	USB - Type A ; выход аудио/наушники - mini phone stereo 3.5 mm
Система питания
Емкость батареи	7000 мАч
Габариты и вес
Ширина	25.6 см
Высота	17.5 см
Глубина	0.9 см
Вес	0.588 кг
Б/У-3 года