Аккумуляторная дрель-шуруповерт Makita 6261 DWPE предназначена для сверления отверстий и для закручивания крепежных элементов. Увеличенная выходная мощность в сочетании с компактностью корпуса обеспечивает высокую  эффективность работ. Быстрозажимный патрон помогает без особых усилий заменить оснастку. 16 установок крутящего момента позволяют выбрать нужный в зависимости от интенсивности работы.
Технические характеристики Makita 6261 DWPE
Тип патрона	быстрозажимной		
Напряжение аккумулятора, В	9.6
Тип аккумулятора	NiCd		
Емкость аккумулятора, А*ч	1.3
Время заряда, ч	0.5		
Диаметр патрона, мм	10
Мах диаметр сверления (дерево), мм	21		
Max диаметр сверления (металл), мм	10
Число ступеней крутящего момента	16+1		
Max крутящий момент, Нм	24
Жестк. вращ. момент, Нм	24		
Мягк.вращ. момент, Нм	14
Число скоростей	2		
Частота вращения шпинделя, об/мин	0-400;0-1300
Наличие удара	нет		
Наличие реверса	есть
Наличие подсветки	нет		
Габариты, мм	192x239
Вес, кг	1.4
Комплектация*
2 аккумулятора 1,3 Ач, Ni-Cd;
Зарядное устройство;
Чемодан;